Maze:
%%%%%%%%%%%%%%%%%%%%%%
% %%        % %      %
%    %%%%%% % %%%%%% %
%%%%%%     P  %      %
%    % %%%%%% %% %%%%%
% %%%% %         %   %
%        %%% %%%   % %
%%%%%%%%%%    %%%%%% %
%.         %%        %
%%%%%%%%%%%%%%%%%%%%%%

Solution:
%%%%%%%%%%%%%%%%%%%%%%
% %%        % %      %
%    %%%%%% % %%%%%% %
%%%%%%     [32m+[0m[32m+[0m[32m+[0m%      %
%    % %%%%%%[32m+[0m%% %%%%%
% %%%% %    [32m+[0m[32m+[0m   %   %
%        %%%[32m+[0m%%%   % %
%%%%%%%%%%[32m+[0m[32m+[0m[32m+[0m %%%%%% %
%[32m+[0m[32m+[0m[32m+[0m[32m+[0m[32m+[0m[32m+[0m[32m+[0m[32m+[0m[32m+[0m[32m+[0m%%        %
%%%%%%%%%%%%%%%%%%%%%%
