% % % % % % % % % % % % % % % % % % % % % % % % % % % %
% P      .         % % % % % % % % % % % % % % % % % % %
%          % % % % % % % % % % % % % % % % % % % % % % % % % % %
%  .    % % % %
%               % % % % % % % % % % % % % % % % % % % %
% % % % % % % % %
%               % % % % % % % % % % % % % % % % % % % %
% % % % % % % % % % % % % % % % % % % % % % % % % % % %
%               % % % % % % % % % % % % % % % % % % % %
% % % % % % % % % % % % % % % % % % % % % % % % % % % %
%               % % % % % % % % % % % % % % % % % % % %
% % % % % % % % % % % % % % % % % % % % % % % % % % % %
%              % % % % % % % % % % % % % % % % % % % %
% % % % % % % % % % % % % % % % % % % % % % % % % % % %
