%%%%%%%%%%%%%%%%%%%%%%%%%%%%%%%%%%%%%
%            %                      %
%            %                      %
%            %                      %
%            %                      %
%            %                      %
%            %      %               %
%            %      %               %
%            %      %               %
%            %      %               %
%            %      %               %
%            %      %               %
%            %      %               %
%%%%%%%%%%%%%%      %%%%%%%%%%%%%%%%%
%            %                      %
%            %                      %
%            %                      %
%                                   %
%                                   %
%                      .            %
%  P                  ..            %
%%%%%%%%%%%%%%%%%%%%%%%%%%%%%%%%%%%%%