%%%%%%%%%%%%%%%%%%%%%%%%%%%%%%%%%%%%%
%      .         .                 P%
%            %                      %
%      .   . %                      %
%            %                      %
%            %                      %
%            %                  .   %
%            %      %               %
%            %      %               %
%            %      %               %
%            %  .   %               %
%      .   . %      %               %
%            %      %               %
%            %      %               %
%%%%%%%%%%%%%%      %%%%%%%%%%%%%%%%%
%            %                      %
%            %                      %
%            %                      %
%                                   %
%                                   %
%                                   %
%                                   %
%%%%%%%%%%%%%%%%%%%%%%%%%%%%%%%%%%%%%