%%%%%%%%%%%%%%%%%%%%%%
% %%       P   %     %
%    %%%%%% % %%%%%% %
%%%%%%..      %      %
%    %.%%%%%% %% %%%%%
% %%%%.%         %   %
%     .   %% %%%   % %
%%%%%%%%% .   %%%%%% %
% .        %     .  % 
%%%                  %
%%%%%%%%%%    %%%%%%%%