%%%%%%%%%%%%%%%%%%%%
%.           ..% P %
%.%%.%%.%%.%%.%% % %
%                % %
%%%%%%%%%%%%%%%%%% %
%.....             %
%%%%%%%%%%%%%%%%%%%%